NO ./filetest/correct.cub
SO ./filetest/correct.cub
WE ./filetest/correct.cub
EA ./filetest/correct.cub

F 220,100,0
C 225,30,0

111111111111
100000000N01
100000000001
100000000001
100000000001
100000000001
100000000001
111111111111
